 ####
##  #
# @$#
##$ ##
## $ #
#.$  #
#..*.#
######
